{ "data":[125, 126, 61, 61, 61, 61, 61, 61, 61, 0, 0, 0, 0, 61, 61, 61, 61, 61, 61, 0, 0, 0, 0, 61, 61, 61, 61, 61, 61, 61, 125, 126,
145, 146, 61, 61, 61, 61, 61, 61, 61, 0, 0, 0, 0, 61, 61, 61, 61, 61, 61, 0, 0, 0, 0, 61, 61, 61, 61, 61, 61, 61, 145, 146,
125, 126, 61, 61, 61, 61, 61, 61, 61, 0, 0, 0, 0, 61, 61, 61, 61, 61, 61, 0, 0, 0, 0, 61, 61, 61, 61, 61, 61, 61, 125, 126,
145, 146, 0, 0, 0, 0, 0, 0, 61, 0, 0, 0, 0, 0, 0, 0, 0, 0, 0, 0, 0, 0, 0, 61, 0, 0, 0, 0, 0, 0, 145, 146,
125, 126, 0, 0, 0, 0, 0, 0, 61, 61, 61, 0, 0, 0, 0, 0, 0, 0, 0, 0, 0, 61, 61, 61, 0, 0, 0, 0, 0, 0, 125, 126,
145, 146, 0, 0, 0, 0, 0, 0, 0, 0, 0, 0, 0, 0, 0, 0, 0, 0, 0, 0, 0, 0, 0, 0, 0, 0, 0, 0, 0, 0, 145, 146,
125, 126, 0, 0, 0, 0, 0, 0, 0, 0, 0, 0, 0, 0, 0, 0, 0, 0, 0, 0, 0, 0, 0, 0, 0, 0, 0, 0, 0, 0, 125, 126,
145, 146, 0, 0, 0, 0, 0, 0, 0, 0, 0, 0, 0, 0, 0, 0, 0, 0, 0, 0, 0, 0, 0, 0, 0, 0, 0, 0, 0, 0, 145, 146,
125, 126, 0, 0, 0, 61, 61, 61, 61, 61, 61, 61, 61, 61, 0, 0, 0, 0, 61, 61, 61, 61, 61, 61, 61, 61, 61, 0, 0, 0, 125, 126,
145, 146, 0, 0, 0, 61, 0, 0, 0, 0, 0, 0, 61, 61, 0, 0, 0, 0, 61, 61, 0, 0, 0, 0, 0, 0, 61, 0, 0, 0, 145, 146,
125, 126, 0, 0, 0, 61, 0, 0, 0, 0, 0, 0, 61, 61, 0, 0, 0, 0, 61, 61, 0, 0, 0, 0, 0, 0, 61, 0, 0, 0, 125, 126,
145, 146, 0, 0, 0, 61, 0, 0, 0, 0, 0, 0, 61, 61, 0, 0, 0, 0, 61, 61, 0, 0, 0, 0, 0, 0, 61, 0, 0, 0, 145, 146,
125, 126, 0, 0, 0, 61, 61, 61, 61, 0, 0, 0, 61, 61, 0, 0, 0, 0, 61, 61, 0, 0, 0, 61, 61, 61, 61, 0, 0, 0, 125, 126,
145, 146, 0, 0, 0, 0, 0, 0, 0, 0, 0, 0, 61, 61, 0, 0, 0, 0, 61, 61, 0, 0, 0, 0, 0, 0, 0, 0, 0, 0, 145, 146,
125, 126, 0, 0, 0, 0, 0, 0, 0, 0, 0, 0, 61, 61, 0, 0, 0, 0, 61, 61, 0, 0, 0, 0, 0, 0, 0, 0, 0, 0, 125, 126,
145, 146, 0, 0, 0, 0, 0, 0, 0, 0, 0, 0, 61, 61, 0, 0, 0, 0, 61, 61, 0, 0, 0, 0, 0, 0, 0, 0, 0, 0, 145, 146,
125, 126, 0, 0, 0, 0, 0, 0, 0, 0, 0, 0, 61, 61, 0, 0, 0, 0, 61, 61, 0, 0, 0, 0, 0, 0, 0, 0, 0, 0, 125, 126,
145, 146, 0, 0, 0, 0, 0, 0, 0, 0, 0, 0, 61, 61, 0, 0, 0, 0, 61, 61, 0, 0, 0, 0, 0, 0, 0, 0, 0, 0, 145, 146,
125, 126, 0, 0, 0, 61, 61, 61, 61, 0, 0, 0, 0, 0, 0, 0, 0, 0, 0, 0, 0, 0, 0, 61, 61, 61, 61, 0, 0, 0, 125, 126,
145, 146, 0, 0, 0, 61, 0, 0, 0, 0, 0, 0, 0, 0, 0, 0, 0, 0, 0, 0, 0, 0, 0, 0, 0, 0, 61, 0, 0, 0, 145, 146,
125, 126, 0, 0, 0, 61, 0, 0, 0, 0, 0, 0, 0, 0, 0, 0, 0, 0, 0, 0, 0, 0, 0, 0, 0, 0, 61, 0, 0, 0, 125, 126,
145, 146, 0, 0, 0, 61, 0, 0, 0, 0, 0, 0, 0, 0, 0, 0, 0, 0, 0, 0, 0, 0, 0, 0, 0, 0, 61, 0, 0, 0, 145, 146,
125, 126, 0, 0, 0, 61, 0, 0, 0, 0, 0, 0, 0, 0, 0, 0, 0, 0, 0, 0, 0, 0, 0, 0, 0, 0, 61, 0, 0, 0, 125, 126,
145, 146, 0, 0, 0, 61, 61, 61, 61, 61, 61, 61, 0, 0, 0, 61, 61, 0, 0, 0, 61, 61, 61, 61, 61, 61, 61, 0, 0, 0, 145, 146,
125, 126, 0, 0, 0, 0, 0, 0, 0, 0, 0, 0, 0, 0, 0, 0, 0, 0, 0, 0, 0, 0, 0, 0, 0, 0, 0, 0, 0, 0, 125, 126,
145, 146, 0, 0, 0, 0, 0, 0, 0, 0, 0, 0, 0, 0, 0, 0, 0, 0, 0, 0, 0, 0, 0, 0, 0, 0, 0, 0, 0, 0, 145, 146,
125, 126, 0, 0, 0, 0, 0, 0, 0, 0, 0, 0, 0, 0, 0, 0, 0, 0, 0, 0, 0, 0, 0, 0, 0, 0, 0, 0, 0, 0, 125, 126,
145, 146, 61, 61, 61, 61, 61, 61, 61, 0, 0, 0, 0, 61, 61, 61, 61, 61, 61, 0, 0, 0, 0, 61, 61, 61, 61, 61, 61, 61, 145, 146,
125, 126, 61, 61, 61, 61, 61, 61, 61, 0, 0, 0, 0, 61, 61, 61, 61, 61, 61, 0, 0, 0, 0, 61, 61, 61, 61, 61, 61, 61, 125, 126,
145, 146, 61, 61, 61, 61, 61, 61, 61, 0, 0, 0, 0, 61, 61, 61, 61, 61, 61, 0, 0, 0, 0, 61, 61, 61, 61, 61, 61, 61, 145, 146]
}