{ "data":[165, 166, 81, 81, 81, 81, 81, 81, 81, 0, 0, 0, 0, 81, 81, 81, 81, 81, 81, 0, 0, 0, 0, 81, 81, 81, 81, 81, 81, 81, 165, 166,
185, 186, 81, 81, 81, 81, 81, 81, 81, 0, 0, 0, 0, 81, 81, 81, 81, 81, 81, 0, 0, 0, 0, 81, 81, 81, 81, 81, 81, 81, 185, 186,
165, 166, 81, 81, 81, 81, 81, 81, 81, 0, 0, 0, 0, 81, 81, 81, 81, 81, 81, 0, 0, 0, 0, 81, 81, 81, 81, 81, 81, 81, 165, 166,
185, 186, 0, 0, 0, 0, 0, 0, 0, 0, 0, 0, 0, 0, 0, 0, 0, 0, 0, 0, 0, 0, 0, 0, 0, 0, 0, 0, 0, 0, 185, 186,
165, 166, 0, 0, 0, 0, 0, 0, 0, 0, 0, 0, 0, 0, 0, 0, 0, 0, 0, 0, 0, 0, 0, 0, 0, 0, 0, 0, 0, 0, 165, 166,
185, 186, 0, 0, 0, 0, 0, 0, 0, 0, 0, 0, 0, 0, 0, 0, 0, 0, 0, 0, 0, 0, 0, 0, 0, 0, 0, 0, 0, 0, 185, 186,
165, 166, 0, 0, 0, 81, 0, 0, 0, 0, 0, 0, 0, 0, 0, 0, 0, 0, 0, 0, 0, 0, 0, 0, 0, 0, 81, 0, 0, 0, 165, 166,
185, 186, 0, 0, 0, 81, 0, 81, 81, 81, 81, 81, 81, 81, 81, 81, 81, 81, 81, 81, 81, 81, 81, 81, 81, 81, 81, 0, 0, 0, 185, 186,
165, 166, 0, 0, 0, 0, 0, 0, 0, 0, 0, 0, 0, 0, 0, 0, 0, 0, 0, 0, 0, 0, 0, 0, 0, 0, 0, 0, 0, 0, 165, 166,
185, 186, 0, 0, 0, 0, 0, 0, 0, 0, 0, 0, 0, 0, 0, 0, 0, 0, 0, 0, 0, 0, 0, 0, 0, 0, 0, 0, 0, 0, 185, 186,
165, 166, 0, 0, 0, 0, 0, 0, 0, 0, 0, 0, 0, 0, 0, 0, 0, 0, 0, 0, 0, 0, 0, 0, 0, 0, 0, 0, 0, 0, 165, 166,
185, 186, 0, 0, 0, 81, 0, 0, 0, 0, 0, 0, 0, 0, 0, 0, 0, 0, 0, 0, 0, 0, 0, 0, 0, 0, 81, 0, 0, 0, 185, 186,
165, 166, 0, 0, 0, 81, 81, 81, 81, 81, 81, 81, 81, 81, 81, 81, 81, 81, 81, 81, 81, 81, 81, 81, 81, 0, 81, 0, 0, 0, 165, 166,
185, 186, 0, 0, 0, 0, 0, 0, 0, 0, 0, 0, 0, 0, 0, 0, 0, 0, 0, 0, 0, 0, 0, 0, 0, 0, 0, 0, 0, 0, 185, 186,
165, 166, 0, 0, 0, 0, 0, 0, 0, 0, 0, 0, 0, 0, 0, 0, 0, 0, 0, 0, 0, 0, 0, 0, 0, 0, 0, 0, 0, 0, 165, 166,
185, 186, 0, 0, 0, 0, 0, 0, 0, 0, 0, 0, 0, 0, 0, 0, 0, 0, 0, 0, 0, 0, 0, 0, 0, 0, 0, 0, 0, 0, 185, 186,
165, 166, 0, 0, 0, 81, 0, 0, 0, 0, 0, 0, 0, 0, 0, 0, 0, 0, 0, 0, 0, 0, 0, 0, 0, 0, 81, 0, 0, 0, 165, 166,
185, 186, 0, 0, 0, 81, 0, 81, 81, 81, 81, 81, 81, 81, 81, 0, 0, 81, 81, 81, 81, 81, 81, 81, 81, 81, 81, 0, 0, 0, 185, 186,
165, 166, 0, 0, 0, 0, 0, 0, 0, 0, 0, 0, 0, 0, 0, 0, 0, 0, 0, 0, 0, 0, 0, 0, 0, 0, 0, 0, 0, 0, 165, 166,
185, 186, 0, 0, 0, 0, 0, 0, 0, 0, 0, 0, 0, 0, 0, 0, 0, 0, 0, 0, 0, 0, 0, 0, 0, 0, 0, 0, 0, 0, 185, 186,
165, 166, 0, 0, 0, 0, 0, 0, 0, 0, 0, 0, 0, 0, 0, 0, 0, 0, 0, 0, 0, 0, 0, 0, 0, 0, 0, 0, 0, 0, 165, 166,
185, 186, 0, 0, 0, 81, 0, 0, 0, 0, 0, 0, 0, 0, 0, 0, 0, 0, 0, 0, 0, 0, 0, 0, 0, 0, 81, 0, 0, 0, 185, 186,
165, 166, 0, 0, 0, 81, 81, 81, 81, 81, 81, 81, 81, 81, 81, 0, 0, 81, 81, 81, 81, 81, 81, 81, 81, 81, 81, 0, 0, 0, 165, 166,
185, 186, 0, 0, 0, 0, 0, 0, 0, 0, 0, 0, 0, 0, 0, 0, 0, 0, 0, 0, 0, 0, 0, 0, 0, 0, 0, 0, 0, 0, 185, 186,
165, 166, 0, 0, 0, 0, 0, 0, 0, 0, 0, 0, 0, 0, 0, 0, 0, 0, 0, 0, 0, 0, 0, 0, 0, 0, 0, 0, 0, 0, 165, 166,
185, 186, 0, 0, 0, 0, 0, 0, 0, 0, 0, 0, 0, 0, 0, 0, 0, 0, 0, 0, 0, 0, 0, 0, 0, 0, 0, 0, 0, 0, 185, 186,
165, 166, 0, 0, 0, 0, 0, 0, 0, 0, 0, 0, 0, 0, 0, 0, 0, 0, 0, 0, 0, 0, 0, 0, 0, 0, 0, 0, 0, 0, 165, 166,
185, 186, 81, 81, 81, 81, 81, 81, 81, 0, 0, 0, 0, 81, 81, 81, 81, 81, 81, 0, 0, 0, 0, 81, 81, 81, 81, 81, 81, 81, 185, 186,
165, 166, 81, 81, 81, 81, 81, 81, 81, 0, 0, 0, 0, 81, 81, 81, 81, 81, 81, 0, 0, 0, 0, 81, 81, 81, 81, 81, 81, 81, 165, 166,
185, 186, 81, 81, 81, 81, 81, 81, 81, 0, 0, 0, 0, 81, 81, 81, 81, 81, 81, 0, 0, 0, 0, 81, 81, 81, 81, 81, 81, 81, 185, 186]
}