{ "data":[85, 86, 41, 41, 41, 41, 41, 41, 41, 0, 0, 0, 0, 41, 41, 41, 41, 41, 41, 0, 0, 0, 0, 41, 41, 41, 41, 41, 41, 41, 85, 86,
105, 106, 41, 41, 41, 41, 41, 41, 41, 0, 0, 0, 0, 41, 41, 41, 41, 41, 41, 0, 0, 0, 0, 41, 41, 41, 41, 41, 41, 41, 105, 106,
85, 86, 41, 41, 41, 41, 41, 41, 41, 0, 0, 0, 0, 41, 41, 41, 41, 41, 41, 0, 0, 0, 0, 41, 41, 41, 41, 41, 41, 41, 85, 86,
105, 106, 0, 0, 0, 0, 0, 0, 0, 0, 0, 0, 0, 0, 0, 0, 0, 0, 0, 0, 0, 0, 0, 0, 0, 0, 0, 0, 0, 0, 105, 106,
85, 86, 0, 0, 0, 0, 0, 0, 0, 0, 0, 0, 0, 0, 0, 0, 0, 0, 0, 0, 0, 0, 0, 0, 0, 0, 0, 0, 0, 0, 85, 86,
105, 106, 0, 0, 0, 0, 0, 0, 0, 0, 0, 0, 0, 0, 0, 0, 0, 0, 0, 0, 0, 0, 0, 0, 0, 0, 0, 0, 0, 0, 105, 106,
85, 86, 0, 0, 0, 0, 0, 0, 0, 0, 0, 0, 0, 0, 0, 0, 0, 0, 0, 0, 0, 0, 0, 0, 0, 0, 0, 0, 0, 0, 85, 86,
105, 106, 0, 0, 0, 41, 41, 41, 41, 41, 41, 41, 41, 0, 0, 0, 0, 0, 0, 41, 41, 41, 41, 41, 41, 41, 41, 0, 0, 0, 105, 106,
85, 86, 0, 0, 0, 41, 0, 0, 0, 0, 0, 0, 0, 0, 0, 0, 0, 0, 0, 0, 0, 0, 0, 0, 0, 0, 41, 0, 0, 0, 85, 86,
105, 106, 0, 0, 0, 41, 0, 0, 0, 0, 0, 0, 0, 0, 0, 0, 0, 0, 0, 0, 0, 0, 0, 0, 0, 0, 41, 0, 0, 0, 105, 106,
85, 86, 0, 0, 0, 41, 0, 0, 0, 0, 0, 0, 0, 0, 0, 0, 0, 0, 0, 0, 0, 0, 0, 0, 0, 0, 41, 0, 0, 0, 85, 86,
105, 106, 0, 0, 0, 41, 0, 0, 0, 0, 0, 0, 0, 0, 0, 0, 0, 0, 0, 0, 0, 0, 0, 0, 0, 0, 41, 0, 0, 0, 105, 106,
85, 86, 0, 0, 0, 41, 41, 41, 41, 41, 41, 41, 41, 41, 0, 0, 0, 0, 41, 41, 41, 41, 41, 41, 41, 41, 41, 0, 0, 0, 85, 86,
105, 106, 0, 0, 0, 41, 0, 0, 0, 0, 0, 0, 0, 0, 0, 0, 0, 0, 0, 0, 0, 0, 0, 0, 0, 0, 41, 0, 0, 0, 105, 106,
85, 86, 0, 0, 0, 41, 0, 0, 0, 0, 0, 0, 0, 0, 0, 0, 0, 0, 0, 0, 0, 0, 0, 0, 0, 0, 41, 0, 0, 0, 85, 86,
105, 106, 0, 0, 0, 41, 0, 0, 0, 0, 0, 0, 0, 0, 0, 0, 0, 0, 0, 0, 0, 0, 0, 0, 0, 0, 41, 0, 0, 0, 105, 106,
85, 86, 0, 0, 0, 41, 0, 0, 0, 0, 0, 0, 0, 0, 0, 0, 0, 0, 0, 0, 0, 0, 0, 0, 0, 0, 41, 0, 0, 0, 85, 86,
105, 106, 0, 0, 0, 41, 41, 41, 41, 41, 41, 41, 41, 41, 41, 0, 0, 41, 41, 41, 41, 41, 41, 41, 41, 41, 41, 0, 0, 0, 105, 106,
85, 86, 0, 0, 0, 0, 0, 0, 0, 0, 0, 0, 0, 0, 0, 0, 0, 0, 0, 0, 0, 0, 0, 0, 0, 0, 0, 0, 0, 0, 85, 86,
105, 106, 0, 0, 0, 0, 0, 0, 0, 0, 0, 0, 0, 0, 0, 0, 0, 0, 0, 0, 0, 0, 0, 0, 0, 0, 0, 0, 0, 0, 105, 106,
85, 86, 0, 0, 0, 0, 0, 0, 0, 0, 0, 0, 0, 0, 0, 0, 0, 0, 0, 0, 0, 0, 0, 0, 0, 0, 0, 0, 0, 0, 85, 86,
105, 106, 0, 0, 0, 0, 0, 0, 0, 0, 0, 0, 0, 0, 0, 0, 0, 0, 0, 0, 0, 0, 0, 0, 0, 0, 0, 0, 0, 0, 105, 106,
85, 86, 41, 41, 41, 41, 41, 0, 0, 41, 41, 41, 0, 0, 0, 0, 0, 0, 0, 0, 41, 41, 41, 0, 0, 41, 41, 41, 41, 41, 85, 86,
105, 106, 0, 0, 0, 0, 0, 0, 0, 0, 0, 0, 0, 0, 0, 0, 0, 0, 0, 0, 0, 0, 0, 0, 0, 0, 0, 0, 0, 0, 105, 106,
85, 86, 0, 0, 0, 0, 0, 0, 0, 0, 0, 0, 0, 0, 0, 0, 0, 0, 0, 0, 0, 0, 0, 0, 0, 0, 0, 0, 0, 0, 85, 86,
105, 106, 0, 0, 0, 0, 0, 0, 0, 0, 0, 0, 0, 0, 0, 0, 0, 0, 0, 0, 0, 0, 0, 0, 0, 0, 0, 0, 0, 0, 105, 106,
85, 86, 0, 0, 0, 0, 0, 0, 0, 0, 0, 0, 0, 0, 0, 0, 0, 0, 0, 0, 0, 0, 0, 0, 0, 0, 0, 0, 0, 0, 85, 86,
105, 106, 41, 41, 41, 41, 41, 41, 41, 0, 0, 0, 0, 41, 41, 41, 41, 41, 41, 0, 0, 0, 0, 41, 41, 41, 41, 41, 41, 41, 105, 106,
85, 86, 41, 41, 41, 41, 41, 41, 41, 0, 0, 0, 0, 41, 41, 41, 41, 41, 41, 0, 0, 0, 0, 41, 41, 41, 41, 41, 41, 41, 85, 86,
105, 106, 41, 41, 41, 41, 41, 41, 41, 0, 0, 0, 0, 41, 41, 41, 41, 41, 41, 0, 0, 0, 0, 41, 41, 41, 41, 41, 41, 41, 105, 106]
}